########################################################
#......................................................#
#....#..##...######..#.....########..##..##..####...#..#
###..#...#...#....#..#........###################..##..#
###..#...#...#....#..#........###...##..##.........##..#
#....#####...###..#..#........#.....##..##..#########..#
#..............#..#..######...#.........##.......####..#
#.............................#....#######...########..#
#..............####........#..#....#######.........##..#
#......#.....########..............................##..#
#......#...................#....#####..............##..#
#####..##..##..#######........###.......#...........#..#
#......##..##..#...........#..###...##..#...#########..#
#..........##..#.....###......###...##..#...........#..#
#..........##..#.....###...#...##...##..#...........#..#
#......##..##...........................#..............#
#......##..##..#.....###...##########..##...#####......#
#..#...##......#.....###...#..#######...#.......#......#
#..#...##....###.....##....#............#.......#####..#
#..#...............###............######...###......#..#
#......#####.......##.........#######............#..#..#
#####......#........#......#.......##########....#..#..#
#.###..##..#####..##########..#######################..#
#......................................................#
########################################################