###############
#.....#..##...>
#.###.#.....#.#
#....$#.##$##.#
#$#$#.#.##.##.#
#$........$...#
###############