#############
#....$$.....#
##.########.#
#..#....$...#
#..$.######.#
###$#####$..>
#.....$...#.#
#############