#############
#.......$$$$#
##.########.#
#..#....$..$#
#....######$#
###.#####$..>
#.........#.#
#############