###############
#.............>
#.###.#.....#.#
#....$#.##$##.#
#$#$#.#.##.##.#
#$........$...#
###############