..............................................#   #.....................................................................
..............................................#   #.....................................................................
..............................................#   #.....................................................................
..............................................#   #.....................................................................
..............................................#   #.....................................................................
..............................................#   #.....................................................................
..............................................#   #.....................................................................
..............................................#   #.....................................................................
..............................................#   #.....................................................................
..............................................#   #.....................................................................
..............................................#   #.....................................................................
..............................................#   #.....................................................................
..............................................#   #.....................................................................
..............................................#   #.....................................................................
..............................................#   #.....................................................................
###############################################   #.....................................................................
                                                  #.....................................................................
###############################################   #.....................................................................
..............................................#   #.....................................................................
..............................................#   #.....................................................................
..............................................#   #.....................................................................
..............................................#   #.....................................................................
..............................................#   #.....................................................................
..............................................#   #.....................................................................
..............................................#   #.....................................................................
..............................................#   #.....................................................................
..............................................#   #.....................................................................
..............................................#   #.....................................................................
..............................................#   #.....................................................................
..............................................#   #.....................................................................
..............................................#   #.....................................................................
........................................................................................................................
........................................................................................................................
........................................................................................................................
........................................................................................................................
........................................................................................................................
........................................................................................................................
........................................................................................................................
........................................................................................................................